"filename", "language", "Java", "Properties", "XML", "CSS", "comment", "blank", "total"
"MainApp.java", "Java", 31, 0, 0, 0, 33, 15, 79
"model/AlphaNumericalSort.java", "Java", 12, 0, 0, 0, 14, 5, 31
"model/DefaultSettings.java", "Java", 106, 0, 0, 0, 69, 29, 204
"model/Filter.java", "Java", 17, 0, 0, 0, 7, 6, 30
"model/FilterStrategy.java", "Java", 6, 0, 0, 0, 13, 4, 23
"model/Help.java", "Java", 52, 0, 0, 0, 35, 17, 104
"model/I18N.java", "Java", 122, 0, 0, 0, 73, 47, 242
"model/IndexPage.java", "Java", 90, 0, 0, 0, 42, 29, 161
"model/LabelSort.java", "Java", 48, 0, 0, 0, 25, 19, 92
"model/PluginLoader.java", "Java", 199, 0, 0, 0, 99, 54, 352
"model/RelevancySort.java", "Java", 69, 0, 0, 0, 24, 20, 113
"model/Settings.java", "Java", 10, 0, 0, 0, 34, 6, 50
"model/SideMenuTypes.java", "Java", 13, 0, 0, 0, 6, 5, 24
"model/Tuple.java", "Java", 25, 0, 0, 0, 27, 9, 61
"model/validator/IpAddrValidator.java", "Java", 18, 0, 0, 0, 15, 11, 44
"model/validator/PortNumValidator.java", "Java", 25, 0, 0, 0, 29, 15, 69
"model/validator/Validatable.java", "Java", 4, 0, 0, 0, 13, 3, 20
"plugininterface/ChainLinkEditPresenter.java", "Java", 16, 0, 0, 0, 30, 9, 55
"plugininterface/ChainLinkHeaderPresenter.java", "Java", 14, 0, 0, 0, 26, 7, 47
"plugininterface/ChainLinkPresenter.java", "Java", 98, 0, 0, 0, 122, 32, 252
"plugininterface/ChainStep.java", "Java", 5, 0, 0, 0, 20, 4, 29
"plugininterface/Content.java", "Java", 14, 0, 0, 0, 32, 9, 55
"plugininterface/ImportPresenter.java", "Java", 20, 0, 0, 0, 42, 12, 74
"plugininterface/Pluginable.java", "Java", 8, 0, 0, 0, 24, 6, 38
"plugininterface/ProcedureInformation.java", "Java", 23, 0, 0, 0, 35, 11, 69
"plugininterface/ProcedurePlugin.java", "Java", 22, 0, 0, 0, 44, 14, 80
"pluginutils/model/content/AbstractImage.java", "Java", 32, 0, 0, 0, 29, 15, 76
"pluginutils/model/content/AbstractList.java", "Java", 22, 0, 0, 0, 23, 10, 55
"pluginutils/model/content/AbstractMatrix.java", "Java", 35, 0, 0, 0, 48, 16, 99
"pluginutils/model/content/AbstractString.java", "Java", 14, 0, 0, 0, 16, 7, 37
"pluginutils/model/content/BinaryMatrix.java", "Java", 54, 0, 0, 0, 18, 10, 82
"pluginutils/model/content/BinaryString.java", "Java", 43, 0, 0, 0, 8, 10, 61
"pluginutils/model/content/BitList.java", "Java", 47, 0, 0, 0, 13, 14, 74
"pluginutils/model/content/BlackWhiteImage.java", "Java", 72, 0, 0, 0, 21, 17, 110
"pluginutils/model/content/ByteList.java", "Java", 53, 0, 0, 0, 13, 13, 79
"pluginutils/model/content/CharacterString.java", "Java", 43, 0, 0, 0, 13, 10, 66
"pluginutils/model/content/ColorImage.java", "Java", 62, 0, 0, 0, 14, 19, 95
"pluginutils/model/content/DecMatrix.java", "Java", 57, 0, 0, 0, 18, 15, 90
"pluginutils/model/content/GreyScaleImage.java", "Java", 75, 0, 0, 0, 22, 18, 115
"pluginutils/model/content/LetterString.java", "Java", 23, 0, 0, 0, 11, 11, 45
"pluginutils/model/content/RGBByteList.java", "Java", 73, 0, 0, 0, 13, 19, 105
"pluginutils/model/content/RGBList.java", "Java", 55, 0, 0, 0, 10, 15, 80
"pluginutils/model/content/RGBMatrix.java", "Java", 70, 0, 0, 0, 18, 18, 106
"pluginutils/model/content/TupleString.java", "Java", 47, 0, 0, 0, 23, 24, 94
"pluginutils/model/steps/BWImageToMatrix.java", "Java", 50, 0, 0, 0, 7, 10, 67
"pluginutils/model/steps/BitListToBinaryString.java", "Java", 35, 0, 0, 0, 7, 10, 52
"pluginutils/model/steps/ByteListToBinaryString.java", "Java", 36, 0, 0, 0, 7, 11, 54
"pluginutils/model/steps/ColorImageToRGBMatrix.java", "Java", 39, 0, 0, 0, 8, 11, 58
"pluginutils/model/steps/DecMatrixToByteList.java", "Java", 35, 0, 0, 0, 7, 9, 51
"pluginutils/model/steps/GreyScaleImageToDecMatrix.java", "Java", 41, 0, 0, 0, 7, 9, 57
"pluginutils/model/steps/MatrixToBitList.java", "Java", 34, 0, 0, 0, 7, 9, 50
"pluginutils/model/steps/RGBByteListToBinaryString.java", "Java", 31, 0, 0, 0, 9, 10, 50
"pluginutils/model/steps/RGBListToRGBByteList.java", "Java", 45, 0, 0, 0, 9, 11, 65
"pluginutils/model/steps/RGBMatrixToRGBList.java", "Java", 36, 0, 0, 0, 9, 10, 55
"pluginutils/presenter/chainlink/BWMatrixChainLinkPresenter.java", "Java", 77, 0, 0, 0, 38, 22, 137
"pluginutils/presenter/chainlink/BinaryStringPresenter.java", "Java", 38, 0, 0, 0, 7, 14, 59
"pluginutils/presenter/chainlink/BitListChainLinkPresenter.java", "Java", 58, 0, 0, 0, 16, 17, 91
"pluginutils/presenter/chainlink/ByteListChainLinkPresenter.java", "Java", 50, 0, 0, 0, 16, 17, 83
"pluginutils/presenter/chainlink/CharacterStringPresenter.java", "Java", 22, 0, 0, 0, 5, 9, 36
"pluginutils/presenter/chainlink/ColorImageChainLinkPresenter.java", "Java", 125, 0, 0, 0, 53, 47, 225
"pluginutils/presenter/chainlink/DecMatrixChainLinkPresenter.java", "Java", 77, 0, 0, 0, 38, 22, 137
"pluginutils/presenter/chainlink/LetterStringPresenter.java", "Java", 29, 0, 0, 0, 2, 11, 42
"pluginutils/presenter/chainlink/RGBByteListChainLinkPresenter.java", "Java", 61, 0, 0, 0, 16, 19, 96
"pluginutils/presenter/chainlink/RGBListChainLinkPresenter.java", "Java", 69, 0, 0, 0, 18, 19, 106
"pluginutils/presenter/chainlink/RGBMatrixChainLinkPresenter.java", "Java", 79, 0, 0, 0, 40, 23, 142
"pluginutils/presenter/chainlink/TupleStringPresenter.java", "Java", 35, 0, 0, 0, 8, 13, 56
"pluginutils/presenter/edit/BinaryStringEditPresenter.java", "Java", 15, 0, 0, 0, 4, 6, 25
"pluginutils/presenter/edit/CharacterStringEditPresenter.java", "Java", 16, 0, 0, 0, 4, 7, 27
"pluginutils/presenter/edit/ColorImageEditPresenter.java", "Java", 16, 0, 0, 0, 4, 7, 27
"pluginutils/presenter/edit/RGBByteListEditPresenter.java", "Java", 16, 0, 0, 0, 4, 7, 27
"pluginutils/presenter/edit/RGBListEditPresenter.java", "Java", 16, 0, 0, 0, 4, 7, 27
"pluginutils/presenter/edit/RGBMatrixEditPresenter.java", "Java", 16, 0, 0, 0, 4, 7, 27
"pluginutils/presenter/header/BinaryStringHeaderPresenter.java", "Java", 22, 0, 0, 0, 10, 8, 40
"pluginutils/presenter/header/CharacterStringHeaderPresenter.java", "Java", 22, 0, 0, 0, 10, 8, 40
"pluginutils/presenter/header/ColorImageHeaderPresenter.java", "Java", 22, 0, 0, 0, 10, 8, 40
"pluginutils/presenter/header/RGBByteListHeaderPresenter.java", "Java", 22, 0, 0, 0, 10, 8, 40
"pluginutils/presenter/header/RGBListHeaderPresenter.java", "Java", 22, 0, 0, 0, 10, 8, 40
"pluginutils/presenter/header/RGBMatrixHeaderPresenter.java", "Java", 22, 0, 0, 0, 10, 8, 40
"presenter/ChainPresenter.java", "Java", 154, 0, 0, 0, 103, 65, 322
"presenter/ChainSplitPane.java", "Java", 9, 0, 0, 0, 1, 5, 15
"presenter/ChainSplitPaneSkin.java", "Java", 1028, 0, 0, 0, 157, 147, 1332
"presenter/HelpPresenter.java", "Java", 60, 0, 0, 0, 41, 25, 126
"presenter/IPresenter.java", "Java", 5, 0, 0, 0, 15, 4, 24
"presenter/IndexPagePresenter.java", "Java", 127, 0, 0, 0, 85, 41, 253
"presenter/NetworkPresenter.java", "Java", 163, 0, 0, 0, 75, 76, 314
"presenter/PluginMenuPresenter.java", "Java", 100, 0, 0, 0, 47, 25, 172
"presenter/Presenter.java", "Java", 25, 0, 0, 0, 26, 13, 64
"presenter/PresenterFactory.java", "Java", 29, 0, 0, 0, 51, 12, 92
"presenter/PresenterManager.java", "Java", 35, 0, 0, 0, 44, 21, 100
"presenter/ProcedureLayoutPresenter.java", "Java", 161, 0, 0, 0, 115, 56, 332
"presenter/SettingsPresenter.java", "Java", 119, 0, 0, 0, 67, 57, 243
"presenter/SideMenuPresenter.java", "Java", 81, 0, 0, 0, 49, 31, 161
"presenter/textformatter/IPAddrFormatter.java", "Java", 25, 0, 0, 0, 16, 10, 51
"presenter/textformatter/PortNumFormatter.java", "Java", 26, 0, 0, 0, 16, 10, 52
"standardplugins/bwimageprocedure/BWImageProcedureInformation.java", "Java", 17, 0, 0, 0, 9, 7, 33
"standardplugins/bwimageprocedure/BWImageProcedurePlugin.java", "Java", 64, 0, 0, 0, 11, 15, 90
"standardplugins/bwimageprocedure/presenter/BWImageImportPresenter.java", "Java", 105, 0, 0, 0, 15, 25, 145
"standardplugins/colorimageprocedure/ColorImageProcedureInformation.java", "Java", 19, 0, 0, 0, 11, 4, 34
"standardplugins/colorimageprocedure/ColorImageProcedurePlugin.java", "Java", 66, 0, 0, 0, 8, 16, 90
"standardplugins/colorimageprocedure/presenter/ColorImageImportPresenter.java", "Java", 142, 0, 0, 0, 36, 40, 218
"standardplugins/greyscaleimageprocedure/GreyScaleImageProcedurePlugin.java", "Java", 64, 0, 0, 0, 11, 16, 91
"standardplugins/greyscaleimageprocedure/GreyScaleProcedureInformation.java", "Java", 17, 0, 0, 0, 7, 7, 31
"standardplugins/greyscaleimageprocedure/presenter/GreyScaleImageImportPresenter.java", "Java", 105, 0, 0, 0, 14, 24, 143
"standardplugins/qrcode/TextQRCodeProcedureInformation.java", "Java", 19, 0, 0, 0, 7, 6, 32
"standardplugins/qrcode/TextQRCodeProcedurePlugin.java", "Java", 42, 0, 0, 0, 6, 15, 63
"standardplugins/qrcode/model/BinaryStringToQRCode.java", "Java", 13, 0, 0, 0, 4, 9, 26
"standardplugins/qrcode/model/QRCode.java", "Java", 4, 0, 0, 0, 1, 4, 9
"standardplugins/qrcode/presenter/QRCodeImportPresenter.java", "Java", 27, 0, 0, 0, 7, 11, 45
"standardplugins/rle/TextRLEProcedureInformation.java", "Java", 19, 0, 0, 0, 7, 5, 31
"standardplugins/rle/TextRLEProcedurePlugin.java", "Java", 56, 0, 0, 0, 3, 16, 75
"standardplugins/rle/model/steps/RLEStep.java", "Java", 43, 0, 0, 0, 0, 19, 62
"standardplugins/rle/presenter/RLEImportPresenter.java", "Java", 94, 0, 0, 0, 14, 29, 137
"resources/kodex/model/help/Help_de.properties", "Properties", 0, 8, 0, 0, 0, 1, 9
"resources/kodex/model/help/Help_en.properties", "Properties", 0, 8, 0, 0, 0, 1, 9
"resources/kodex/model/languages/Languages.properties", "Properties", 0, 2, 0, 0, 0, 0, 2
"resources/kodex/model/languages/Languages_de.properties", "Properties", 0, 43, 0, 0, 0, 1, 44
"resources/kodex/model/languages/Languages_en.properties", "Properties", 0, 43, 0, 0, 0, 1, 44
"resources/kodex/model/settings/Default_Settings.properties", "Properties", 0, 4, 0, 0, 0, 0, 4
"resources/kodex/model/settings/User_Settings.properties", "Properties", 0, 4, 0, 0, 0, 0, 4
"resources/kodex/model/sorting_relevancy.properties", "Properties", 0, 0, 0, 0, 0, 1, 1
"resources/kodex/presenter/chainlayout.fxml", "XML", 0, 0, 8, 0, 0, 4, 12
"resources/kodex/presenter/chainlinktemplate.fxml", "XML", 0, 0, 92, 0, 0, 3, 95
"resources/kodex/presenter/editlayout.fxml", "XML", 0, 0, 23, 0, 0, 3, 26
"resources/kodex/presenter/headertemplate.fxml", "XML", 0, 0, 12, 0, 0, 3, 15
"resources/kodex/presenter/helppage.fxml", "XML", 0, 0, 49, 0, 0, 3, 52
"resources/kodex/presenter/importexample.fxml", "XML", 0, 0, 25, 0, 0, 3, 28
"resources/kodex/presenter/indexpage.fxml", "XML", 0, 0, 76, 0, 0, 3, 79
"resources/kodex/presenter/inputexample.fxml", "XML", 0, 0, 30, 0, 0, 3, 33
"resources/kodex/presenter/minisidemenu.fxml", "XML", 0, 0, 81, 0, 0, 3, 84
"resources/kodex/presenter/networkpage.fxml", "XML", 0, 0, 135, 0, 0, 3, 138
"resources/kodex/presenter/overviewbuttontemplate.fxml", "XML", 0, 0, 3, 0, 0, 3, 6
"resources/kodex/presenter/pluginpage.fxml", "XML", 0, 0, 55, 0, 0, 3, 58
"resources/kodex/presenter/procedurebuttontemplate.fxml", "XML", 0, 0, 17, 0, 0, 3, 20
"resources/kodex/presenter/procedurelayout.fxml", "XML", 0, 0, 34, 0, 0, 3, 37
"resources/kodex/presenter/settingspage.fxml", "XML", 0, 0, 84, 0, 0, 3, 87
"resources/kodex/presenter/sidemenu.fxml", "XML", 0, 0, 37, 0, 0, 3, 40
"resources/kodex/presenter/style.css", "CSS", 0, 0, 0, 429, 15, 174, 618
"resources/kodex/standardplugins/bwimageprocedure/presenter/bwimport.fxml", "XML", 0, 0, 25, 0, 0, 3, 28
"resources/kodex/standardplugins/bwimageprocedure/presenter/style.css", "CSS", 0, 0, 0, 113, 4, 51, 168
"resources/kodex/standardplugins/colorimageprocedure/presenter/importexample.fxml", "XML", 0, 0, 25, 0, 0, 3, 28
"resources/kodex/standardplugins/colorimageprocedure/presenter/style.css", "CSS", 0, 0, 0, 113, 4, 51, 168
"resources/kodex/standardplugins/greyscaleimageprocedure/presenter/greyscaleimport.fxml", "XML", 0, 0, 25, 0, 0, 3, 28
"resources/kodex/standardplugins/greyscaleimageprocedure/presenter/style.css", "CSS", 0, 0, 0, 113, 4, 51, 168
"resources/kodex/standardplugins/rle/presenter/importexample.fxml", "XML", 0, 0, 25, 0, 0, 3, 28
"resources/kodex/standardplugins/rle/presenter/style.css", "CSS", 0, 0, 0, 113, 4, 51, 168
"test/java/kodex/MainAppTest.java", "Java", 7, 0, 0, 0, 1, 4, 12
"Total", "-", 6371, 112, 861, 881, 2793, 2402, 13420